R  10800 7200
NO ./map/textures/brick.xpm
SO ./map/textures/blue.xpm
WE ./map/textures/wood.xpm
EA ./map/textures/grey.xpm
S ./map/textures/chest.xpm
F 224,172,105
C 205,249,255
1111111111111
1000000000001
1000000000001
1000000001011
100000N000001
1111111111111
