R  1080 720
NO ./textures/brick.xpm
SO ./textures/blue.xpm
WE ./textures/wood.xpm
EA ./textures/grey.xpm

S ./textures/chalice.xpm
F 224,172,105
C 205,249,255

11111111111111111111111111
10010000010011001000001001
10001000000011001000001001
10010000010011001000000001
10001000000011001000000001
10000001000011001000001001
10010000010000001000001001
10000001000011001000001001
10010000010N11001000001001
10010000010011001000001001
10001020000011001000001001
10000001000011000000001001
10010000010011001000001001
11111111111111111111111111
